1111111111111111111111
1000000000000000000001
1000000000000000011001
1000000111111100000101
1000000000000000000101
1000000000N00000000101
1111111111111111111111