111111111111111111111111111111111111
100000000000000000000000000000000001
101000000111111100000000000000000001
100100000100000100000000000000000001
101000000111110100000E00000000000001
100000000000000000000000000000000001
100000000000000000000000000000000001
111111111111111111111111111111111111