111111111111111111
100000010000000001
10N000110000000001
100011100000000001
100000000100000001
111111111111111111