NO  ./xpm/BlackWall.xpm      
SO  ./xpm/bluestone.xpm        
WE  ./xpm/eagle.xpm
EA  ./xpm/purplestone.xpm

C 225,100,200      
F 2,30,0    

111111111111111111111111
1000000000110000000000001
11011000001110000000000001
100100000000000000000W0111111111
111111111011000001110000000000001
100000111111000001110111111111111
1111011 111111011100000010001
11110111111111011101010010001
11000000110101011100000010001
10000000000000001100011110001
1000000000000001101011010001
110000011101010111110111100111
11110111 1110101 101111010001
11111111 1111111 111111111111